NO ./path_to_the_north_texture.xpm
SO ./path_to_the_south_texture.xpm
WE ./path_to_the_west_texture.xpm
EA hi.xpm

F 220,100,200
C 225,30,0




111111111111111111111111
100000000000000000000001
100000100000000010000001
100000000000000000000001
100000000000000000000001
1000000000N0000000000001
100000000010000000000001
100000000000000000000001
100000000000000000000001
100010000000001000000001
100000000000000000000001
100000000100000000000001
100000000000000000100001
100000000010000000000001
100000000000000000000001
100000000000001000000001
100000000000000000000001
100000000000100000000001
100000000000000000000001
100000000000000000000001
111111111111111111111111