
WE texture/zli.xpm

EA texture/egypt.xpm

NO texture/cloud.xpm
SO texture/zlig.xpm


F 50,50,0
C 0,0,139

111111111111111111111111
100000000000000000000001
100000000000000000000001
100000000100001000000001
100000100000000000000001
1010000010000100000000011111111111
1000000000100N0010000001   1111111
100100000000000000000001   110111
100000001000000010000001    111111
100000000000000000000001    1111111    
1111111111111111111111111
