NO ./path_to_the_north_texture.xpm
SO ./path_to_the_south_texture.xpm
WE ./path_to_the_west_texture.xpm
EA hi.xpm

F 220,100,200
C 225,30,0














1111
10N1
1111