
WE texture/s.xpm

EA texture/eagle.xpm

NO texture/red_brick.xpm
SO texture/mossy.xpm


F 50,50,1
C 0,0,139

111111111111111111111111
100000000000000000000001
100000000000000000000001
100000000100001000000001
100000100000000000000001
1010000010000000000000011111111111
100000000010000010000001   1111111
1001000000000000000000E1   110011
100000001000000010000001    111111
100000000000000000000001    1111111    
1111111111111111111111111