EA texture/red_brick.xpm
WE texture/blue_stone.xpm

NO exture/eagle.xpm
SO texture/mossy.xpm


F 50,50,50
C 0,0,139

111111111111111111111111
100000000000000000000001
100000100000000010000001
100000000000000000000001
100000000000000000000001
100000N00000000000000001
100000000010000000000001
100000000000000000000001
100000000000000000000001
100010000000001000000001
100000000000000000000001
100000000100000000000001
100000000000000000100001
100000000010000000000001
100000000000000000000001
100000000000001000000001
100000000000000000000001
100000000000100000000001
100000000000000000000001
100000000000000000000001
111111111111111111111111