NO      ./path_to_the_north_texture.xpm

SO ./path_to_the_south_texture.xpm
WE ./path_to_the_west_texture.xpm
EA     path_to_the_east_texture.xpm

F     220,100,0
C     225,30,0







111111111111111111

111111111111111111111
            111111111111111111111111
        111111111111111111111111111111111111111111          
1111111110011000000000000000001       
101100S00111000000000000000001
10010000000000000000000000001
11111111101100011100000000001
11111111111111111111111111111111111
11110111111111011100000010001
11110111111111011101010010001
1100000001101011100000010001111
1000000001110000000110000001111
1000000000000000110101001000111
1100000111010101111101111000111
1111111111111111111111111111111