NO ./path_to_the_north_texture.xpm
SO ./path_to_the_south_texture.xpm
WE ./path_to_the_west_texture.xpm
EA hi.xpm

F 0,225,0
C 0,0,225

111111111111111111111111111111111111
100000000000000000000000000000000001
100000100000000010000001000000100001
100000100000000000000000000000000001
100000100000000000000000000000000001
100000100000000000000000000000000001
100000100010000000000000000000000001
100000100010000000000000000000000001
100000100010000000000000000000000001
100010100010001000000100000010000001
100000100010000000000000000000000001
100000100110000000000000000000000001
100000100010000000000000000000000001
100000100000000N00000010000001000001
100000100000000000000000000000000001
100000100000000000000000000000000001
100000100010000000000000000000000001
100000100010000000000000000000000001
100000100010000000000000000000000001
100010100010001000000100000010000001
100000100010000000000000000000000001
100000000010000000000000000000000001
100000000010001000000100000010000001
100000000010000000000000000000000001
100000000010100000000000000000000001
100000000010000000000000000000000001
100000000000000000000000000000000001
111111111111111111111111111111111111